################################
################################
################################
#################               
#################               
#################               
#################            OO 
#################          #####
#################          #####
####                   #########
####                 O #########
####                 O #########
####                 O #########
####         ###################
####       O ###################
#######  #######################
#######  #######################
#######  #######################